@wwwxywwxwwxwyxwwxwy
x..................x
w..................w
y..................w
w.....wwwww........x
w.........w........w
w.........w........w
x.........w........x
y..................w
w..................w
w..................x
x.......x.x........w
y..dd..xx.xx...dd..w
wxwyywwxxzwwwxxxwwwy
....................