@wwwxywwxwwxwyxwwxwy
x.....w......w.....x
w......w....w......w
y.......w..w.......w
w.......w..w.......x
w......wb..bw......w
w.B...wb....bw...B.w
x..................x
y........S.........w
w........S.........w
w..................x
x.......x..x.......w
y..dd..xx..xx..dd..w
wxwyywwxxzzwwxxxwwwy
....................