@wwwxywwxwwxwyxwwxwy
x.....w......w.....x
w......w....w......w
y.......w..w.......w
w.......w..w.......x
w......w....w......w
w.....w......w.....w
x..................x
y........s.........w
w..................w
w..................x
x.......x..x.......w
y..dd..xx..xx..dd..w
wxwyywwxxzzwwxxxwwwy
....................